12 12 12 12 12 12 12 12 12 12 12 12 12 12 12 12
12 12 12 12 12 12 12 12 12 12 12 12 12 12 12 12
12 12 13 4 2 3 2 2 2 3 5 2 4 12 12 12
12 12 13 4 90 0 0 0 0 0 0 1 4 12 12 12
12 12 13 4 0 0 0 0 80 0 0 1 4 12 12 12
12 12 13 4 1 4 4 4 4 4 4 1 4 12 12 12
12 12 13 4 1 4 4 4 4 4 4 1 4 12 12 12
12 12 13 4 1 2 2 3 2 4 4 70 4 12 12 12
12 12 13 4 0 50 0 0 60 4 4 9 4 12 12 12
12 12 13 6 7 6 6 6 6 6 7 7 6 12 12 12
12 12 12 14 14 14 14 14 14 14 14 14 14 12 12 12
12 12 12 12 12 12 12 12 12 12 12 12 12 12 12 12