12 12 12 12 12 12 12 12 12 12 12 12 12 12 12 12
12 12 12 12 12 12 12 12 12 12 12 12 12 12 12 12
12 13 4 2 0 2 0 2 0 2 0 2 2 4 12 12
12 13 4 90 50 0 50 0 50 0 50 8 9 4 12 12
12 13 4 4 0 4 0 4 0 4 0 4 4 4 12 12
12 13 4 4 70 4 70 4 70 4 70 4 6 6 12 12
12 13 4 4 70 4 70 4 70 4 70 4 14 14 12 12
12 13 6 6 91 6 0 6 0 6 0 6 12 12 12 12
12 12 14 14 10 14 10 14 10 14 10 14 12 12 12 12
12 12 12 12 13 92 13 0 13 0 13 0 12 12 12 12
12 12 12 12 12 10 12 10 12 10 12 10 12 12 12 12
12 12 12 12 12 12 12 12 12 12 12 12 12 12 12 12