12 12 13 4 2 2 2 2 2 4 0 9 12 12 12 12
12 12 13 4 0 0 91 0 0 2 0 0 2 2 2 4
12 12 13 4 0 0 0 0 0 0 0 0 0 0 0 4
12 12 13 4 0 0 10 11 0 80 0 10 11 0 0 4
12 12 13 4 0 80 12 13 0 0 0 0 0 0 0 4
12 12 13 4 0 0 0 0 0 0 4 2 2 0 0 4
12 12 13 4 2 70 4 4 4 70 4 0 0 0 0 4
12 12 13 4 81 70 2 2 2 70 4 0 0 0 70 4
12 12 13 6 4 70 0 8 0 70 2 60 0 70 90 4
12 12 12 13 4 70 4 4 4 70 81 6 6 6 6 6
12 12 12 13 6 6 6 92 6 6 6 14 14 14 14 14
12 12 12 12 14 14 14 14 14 14 14 12 12 12 12 12
