12 12 12 12 12 12 12 12 12 12 12 12 12 12 12 12
12 12 12 12 12 12 12 12 12 12 12 12 12 12 12 12
12 12 12 12 13 4 2 2 2 2 2 2 2 4 12 12
12 12 12 12 13 4 0 90 0 50 70 70 9 4 12 12
12 13 4 2 2 2 0 0 0 0 2 6 2 6 12 12
12 13 4 91 81 0 0 0 0 70 70 10 0 14 12 12
12 13 4 2 2 4 0 0 0 70 70 12 92 12 12 12
12 13 4 0 0 2 0 0 0 0 2 2 2 4 12 12
12 13 4 60 0 70 70 0 0 0 70 70 8 4 12 12
12 13 6 6 6 6 6 6 6 6 6 6 6 6 12 12
12 12 14 14 14 14 14 14 14 14 14 14 14 14 12 12
12 12 12 12 12 12 12 12 12 12 12 12 12 12 12 12