12 12 12 12 12 12 12 12 12 12 12 12 12 12 12 12
12 12 12 12 12 13 0 91 0 12 12 12 12 12 12 12
12 12 12 12 13 4 2 10 10 12 12 13 9 12 12 12
12 12 12 12 13 4 0 0 0 0 70 70 90 12 12 12
12 12 12 12 13 4 0 80 70 0 70 70 0 12 12 12
12 13 60 12 13 4 70 0 0 0 10 10 10 12 12 12
12 13 70 12 13 2 0 0 0 0 12 12 12 12 12 12
12 13 70 12 13 0 0 2 0 0 12 12 12 12 12 12
12 13 0 20 20 0 0 70 0 0 70 70 8 12 12 12
12 13 0 20 20 0 0 0 0 92 10 10 10 12 12 12
12 12 10 14 14 10 10 10 10 10 12 12 12 12 12 12
12 12 12 12 12 12 12 12 12 12 12 12 12 12 12 12