12 12 12 12 12 12 12 12 12 12 12 12 12 12 12 12
12 12 12 12 12 12 12 12 12 12 12 12 12 12 12 12
12 12 13 4 2 2 2 12 12 13 2 2 2 4 12 12
12 12 13 4 0 0 0 12 12 13 0 0 8 4 12 12
12 12 13 4 0 0 0 81 70 70 0 0 0 4 12 12
12 12 13 4 90 0 0 12 12 13 0 0 0 4 12 12
12 12 13 4 9 91 0 12 13 4 2 70 2 4 12 12
12 12 13 4 92 0 0 12 13 4 0 0 0 4 12 12
12 12 13 4 0 0 0 12 13 4 0 60 0 4 12 12
12 12 13 6 6 6 6 12 13 6 6 6 6 6 12 12
12 12 12 14 14 14 14 12 12 14 14 14 14 14 12 12
12 12 12 12 12 12 12 12 12 12 12 12 12 12 12 12