12 12 12 12 12 12 12 12 12 12 12 12 12 12 12 12
12 12 12 12 12 12 12 12 12 12 12 12 12 12 12 12
12 12 12 12 12 12 12 12 12 12 12 12 12 12 12 12
12 12 13 4 2 2 5 4 2 5 2 4 2 4 12 12
12 12 13 4 0 0 0 4 0 9 0 4 0 4 12 12
12 12 13 4 0 90 0 4 0 0 0 4 8 4 12 12
13 4 2 2 2 2 2 2 0 0 0 4 0 4 12 12
13 4 92 0 0 0 0 81 0 0 0 4 0 4 12 12
13 6 6 7 6 6 6 6 6 7 6 6 6 6 12 12
12 14 14 14 14 14 14 14 14 14 14 14 14 14 12 12
12 12 12 12 12 12 12 12 12 12 12 12 12 12 12 12
12 12 12 12 12 12 12 12 12 12 12 12 12 12 12 12