12 12 12 12 12 12 12 12 12 12 12 12 12 12 12 12
12 12 12 12 12 12 12 12 12 12 12 12 12 12 12 12
12 12 12 12 12 12 12 12 13 5 12 12 12 12 12 12
12 13 4 2 2 3 2 2 5 81 2 5 2 4 12 12
12 13 4 0 0 0 70 70 70 0 0 0 0 4 12 12
12 13 4 91 0 8 70 70 70 0 0 0 9 4 12 12
12 13 4 0 0 0 70 70 70 0 0 0 0 4 12 12
12 13 6 6 6 7 6 6 7 81 4 50 4 6 12 12
12 12 14 14 14 14 14 14 14 6 4 0 4 14 12 12
12 12 12 12 12 12 12 12 12 14 4 60 4 12 12 12
12 12 12 12 12 12 12 12 12 13 6 6 7 12 12 12
12 12 12 12 12 12 12 12 12 12 14 14 14 12 12 12