12 12 12 12 12 12 12 12 12 12 12 12 12 12 12 12
13 4 0 70 2 0 0 0 91 0 12 13 4 9 12 12
13 2 90 70 0 0 0 0 0 0 12 13 2 0 12 12
13 0 0 70 0 4 0 0 2 0 20 20 0 50 12 12
13 2 4 4 0 2 0 80 0 2 12 13 4 4 12 12
12 14 2 4 0 0 0 0 0 0 12 13 4 2 12 12
12 12 14 2 2 80 0 2 2 0 4 4 4 92 12 12
12 12 12 11 0 0 0 0 0 0 4 4 4 8 12 12
12 12 12 13 0 0 4 0 0 0 2 4 4 0 12 12
12 12 60 20 0 0 6 0 0 80 0 2 2 0 12 12
12 12 12 12 14 14 14 14 11 0 0 81 81 0 12 12
12 12 12 12 12 12 12 12 13 6 6 6 6 6 12 12